1111111111111111111111
1C0000000000C000000011
1110010100100000101001
1010010010101010001C01
10000P0000000000011111
1010C000000C0000001001
1000010000000000001001
1000010010101000F00001
1000010000000100010011
1010010010101010001001
1C000000000000000E0001
1111111111111111111111
